####################
#   P              #
#   B   B   B      #
#   ##      ##     #
#   .   .   .      #
#                  #
#      #####       #
#                  #
#                  #
####################
