####################
#                  #
#   P     B        #
#   ##    #        #
#   .     #   B    #
#   .     #   .    #
#         #        #
#         ##########
#                  #
####################
