####################
#                  #
#   P              #
#        B         #
#        .         #
#                  #
#                  #
#                  #
#                  #
####################